----------------------------------------------------------------------------------------------------------------------------------------------------------------------------------------------------------
----------------------------------------------------------------------------------------------------------------------------------------------------------------------------------------------------------
----------------------------------------------------------------------------------------------------------------------------------------------------------------------------------------------------------
----------------------------------------------------------------------------------------------------------------------------------------------------------------------------------------------------------
----------------------------------------------------------------------------------E-----------------------------------------------------------------------------------------------------------------------
----------------------Q---------------------------------------------------------SSSSSSSS---SSSQ--------------?-----------SSS----SQQS--------------------------------------------------------XX------------
-------------------------------------------------------------------------------------------------------------------------------------------------------------------------------------------XXX------------
-------------------------------------------------------------------------------E----------------------------------------------------------------------------------------------------------XXXX------------
----------------------------------------------------------------S------------------------------------------------------------------------------------------------------------------------XXXXX------------
----------------Q---S?SQS---------------------[[---------[[------------------S?S--------------S-----SS----Q--Q--Q-----S----------SS------X--X----------XX--X------------SSQS------------XXXXXX------------
--------------------------------------[[------[[---------[[-----------------------------------------------------------------------------XX--XX--------XXX--XX--------------------------XXXXXXX------------
----------------------------[[--------[[------[[---------[[----------------------------------------------------------------------------XXX--XXX------XXXX--XXX-----[[--------------[[-XXXXXXXX------------
---------------------E------[[--------[[-E----[[-----E-E-[[------------------------------------E-E--------E-----------------EE-E-E----XXXX--XXXX----XXXXX--XXXX----[[---------EE---[[XXXXXXXXX--------X---
XXXXXXXXXXXXXXXXXXXXXXXXXXXXXXXXXXXXXXXXXXXXXXXXXXXXXXXXXXXXXXXXXXXXX--XXXXXXXXXXXXXXX---XXXXXXXXXXXXXXXXXXXXXXXXXXXXXXXXXXXXXXXXXXXXXXXXXXXXXXXXXXXXXXXX--XXXXXXXXXXXXXXXXXXXXXXXXXXXXXXXXXXXXXXXXXXXXXXX
