-----------------------------------------------------------------------------------------------------------------------------------------------------------------------------------------------------
-----------------------------------------------------------------------------------------------------------------------------------------------------------------------------------------------------
-----------------------------------------------------------------------------------------------------------------------------------------------------------------------------------------------------
---------------------------------------------------------------------------------------------------------------------------------------------------------------------------------------XX------------
---------------------------------------------------------------------------------------------------------------------------------------------------------------------------------------XX------------
---------------------SSSS---------------------QQQQQ-----------SSSS--------SSSSS------SSSS-----------------------------?SSS-----------------------------------SSSSS---?-------------S---XX------------
---------------------------------------------------------------------------------------------------------------------------------------------------------------------------------------XX------------
----------------------------------------------------------------------------------------------------------------------------E----------------------------------------------------------XX------------
-----------------X----------------------E---------------------------E----------------------------E------------------E------[[----------------------------------------------------------XX------------
--------S?S-----EX---S-----X-----------[[----E?QQQQ----------S-----[[---QQQQ--QQQ---------------[[-----------------[[---E--[[-----------------------------S---E-----------E-------SS---XX------------
---------------XXX---------X-----------[[--------------------------[[---------------------------[[-----------E-----[[--[[--[[----------------------X---------------E-----[[------------XX------------
--------------XXXX---------XX----------[[--------------------------[[---------------------------[[----------[[-----[[--[[--[[------------------E---X---------------------[[------------XX------------
-------------XXXXX----EE---XX---EE-----[[-----------E-E--E--EE-E---[[-------E-EE-------------E--[[--------E-[[--E--[[--[[--[[----------------------X-----EE--------------[[E-----------XX--------X---
XXXXXXXXXXXXXXXXXXXXXXXXXXXXXXXXXXXXXXXXXXXXXXXXXXXXXXXXXXXXXXXXXXXXXXXXXXXXXXXXXXXXX----XXXXXXXXXX---XXXXXXXXXXXXXXXXXXXXXXXXXXXXXX---XXXXXXXXXX--XXXXXXXXXXXXXXXXXXXXXXXXXXXXXXXXXXXXXXXXXXXXXXXXXX
