-------------------------------------------------------------------------------------------------------------------------------------------------------------------------------------------
------------------------------------------------------------------------------------------------------------------------------------------------------------XXX----------------------------
S-----SSSSSSSSSSSSSSSSSSSSSSSSSSSSSSSSSSSSSSSSSSSSSSSSSSS----------SSSSSSSSSSSSSSSSSSSSSSSSSSSSSSSSSSSSSSSSSSSSS-------SSSS-----SSSSSSSSSSSSSSSSSSSSSSSSSSS-----SSSSSSSSSSSSSSSSSSSSSSSSSSS
S-------------------SSSSSSSSSSSSSSSSSSSSSSSSSSSS----------------------------------------------------------------------------------------------------------------SSSSSSSSSSSSSSSS-----------
S-------------------SSSSSSSSSSSSSSSSSSSSSSSSSSSS-----------XXX----------------------------------------------------------?---------------------------------------SSSSSSSSSSSSSSSS-----------
S-------------------SSSSSSSSSSSSSSSSSSSSSSSSSSSS--QQ------------SSS------------E---------------------------------------S??--------------------------------------SSSSSSSSSSSSSSSS-----E-----
S-----------------------------------------------------------------------------[[--------------------------------------------XXX---------------------------------S-------------------[[-----
S---------------------------------------------------------------S-------------[[--------------------------------------------------------------------------------S-------------------[[-----
S---------------------------?-------------E-EE-----------------S-S------------[[-------S--------------------E----------------------------------E-----------------?oooooooooo--------[[-----
S---------------------SSSSSS??SSSSSSSSSSSSSSSSSS--QQ--QQQ---------S------E--SS[[SS---E----E----------------[[------XXX-SSSS----------------E--[[-----------------??SSSSSSSSS----XX--[[-----
S---------------------SSSSS---SSSSSSSSSSSSSSSSSS------------------------[[----[[----[[---[[-------------XX-[[--XXX------------------E-----[[--[[----------XX-------------------XXX--[[---SS
S---------------------SSSSS---SSSSSSSSSSSSSSSSSS------------------------[[----[[----[[---[[------------XXX-[[--XXX-----------------[[-----[[--[[---------XXXXXX---------------XXXX--[[---SS
S--------------------------oooSSSSSSSSSSSSSSSSSS------------------------[[-E--[[----[[---[[--------E-E-XXX-[[--XXX-----------------[[---E-[[--[[--------XXXX------------EE---XXXXX--[[---SS
XXXXXXXXXXX--XX--X---XXXXXXXXXXXXXXXXXXXXXXXXXXXXXXXXXXXX------XXXXXXXXXXXXXXXXXXXXXXXXXXXXXXXXXXXXXXXXXX--XX--XX------XXXX------XXXXXXXXXXXXXXX--XXXXXXXXX-----XXXXXXXXXXXXXXXXXXXXXXX--XX
