--------------------------------------------------------------------------------------------------------------------------------------------------------------------------------
--------------------------------------------------------------------------------------------------------------------------------------------------------------------------------
------------------------------------------------------------------------------------------------------------------------------------------------?-------------------------------
--------------------------------------------------------------------------------------------------------------------------------------------------------------------------------
--------------------------------------------------------------------------------E-----------------------------------------------------------------------------------------------
--------------------?SS-----------------------------------------------------SSSSSS----S----------------------------------------SSSSS------------------------------XX------------
--------------------------------------------------------------------------------------------------------------------------------------------------SS-------------XXX------------
---------------------------------------------------------b---------------------------------------------------------------------------------------------X--------XXXX------------
---------------------------------------------------------b-------------------E--------------------------------------------------E-------------SS------XX-------XXXXX------------
--------------------------------QQQQ-------------------SSXSS----------E----SSSSSSS-----E---------------E-----------------------SSSSS-----------------XXX------XXXXXX------------
-----------------E---b-----------------b-----E---b-------------------[[---------------[[--------------[[-----E------------E-----------X----b--------XXXX-----XXXXXXX------------
------------b--------b-------b--E------b---------b-----------b-------[[---------------[[---------b----[[----[[-----b-----[[-----------X----b-------XXXXX----XXXXXXXX------------
------------b--------b-------b-------------------b-----------b-------[[---------------[[---------b----[[-E--[[-----b-----[[-----------X----b------XXXXXX---XXXXXXXXX--------X---
XXXXXXXXXXXXXXXXXXXXXXXXXXXXXXXXXXXXXXXXXXXXXXXXXXXXXXXXXXXXXXXXXX--XXXXXXXXXXXXXXXXXXXXXXXXXXXXXXXXXXXXXXXXXXXXXXXXXXXXXXXXXXXXXXXXXXXXXXXXXXXXX-XXXXXXXXXXXXXXXXXXXXXXXXXXXXXX
