--------------------
--------------------
--------------------
--------------------
SSSS----------------
--------------------
--------------------
-------------------E
S-----X-----------[[
------X-----------[[
------XX----------[[
-EE---XX---EE-----[[
XXXXXXXXXXXXXXXXXXXX
