--------------------
--------------------
--------------------
--------------------
----------------?SSS
--------------------
--------------------
--------------E-----
-------------[[---E-
-------E-----[[--[[-
------[[-----[[--[[-
----E-[[--E--[[--[[-
XXXXXXXXXXXXXXXXXXXX
