--------------------
--------------------
--------------------
--------------------
-------------------S
--------------------
--------------------
---------------X----
------S?S-----EX---S
-------------XXX----
------------XXXX----
-----------XXXXX----
XXXXXXXXXXXXXXXXXXXX
