------------------------------------------------------------------------------------------------------------------------------------------------------------------------------------------------------------------------------
------------------------------------------------------------------------------------------------------------------------------------------------------------------------------------------------------------------------------
------------------------------------------------------------------------------------------------------------------------------------------------------------------------------------------------------------------------------
------------------------------------------------------------------------------------------------------------------------------------------------------------------------------------------------------------------------------
------------------------------------------------------------------------------------------------------------------------------------------------------------------------------------------------------------------------------
------------------Q--------------------------------------Q-Q-------------------------S-------------------------------------------------------QQQQ---------------------------------------------------------------XX------------
--------------------------------------------------------------------------------------------------oooo----------oooo------------oooo---------------------------------------------------------------------------XXX------------
--------------------------------------------------------------------------------------------------------------------------------------------------------------------------------------------------------------XXXX------------
-----------------------------------oo-------------------------------------------------------------------------E---------------E------------------------------------------------------------------------------XXXXX------------
---------------E--?---------------o--o-------------------Q-Q-----------------------QQQQ----------------------[[--------------[[------------QQ?SSQQQ---------------------------------------------------------XXXXXX---S--------
--------------[[--------------------------------------------------------------------------------X------------[[--------------[[------------------------------E------------------------X--------------------XXXXXXX------------
--------------[[--------------------------------------------------------------------------------X------------[[--------------[[-----------------------------[[------------------------X-------------------XXXXXXXX------------
--------------[[--------------------------------------------------------------------------------X------------[[--------------[[-----------------------------[[------------------------X------------------XXXXXXXXX--------X---
XXXXXXXXXXXXXXXXXXXXXXXXX--XXXXXXXXXXXXXXXXXXXXXXXXXXXXXXXXXXXXXXXXXXXX----XXXXXXXXXXXXXXXXXXXXXXXXXXXXXXXXXXXXXXXXXXXXXXXXXXXXXXXXXXXXXXXXXXX--XXXXXXXXXXXXXXXXXXXXXXX---XXX--XXXXXXXX--XXXXXXXXXXXXXXXXXXXXXXXXXXXXXXXXXXXXX
